NO ./
SO ./textures/south_texture.xpm
WE ./asdf
EA ./textures/east_texture.xpm
C 255,255,255
F 0,0,0

    1111111111111111111111111
    1000000000000000000000001
    1100001111000000000000001
    1000000000000011111111101111
111111111000000000000000000000001
100000000000000000000000000001111
10000000000000W10000000000001
10000000000000000000000000001
1111111111000000000000000001
10000000000000000000000000001
10000000000000000001010000001
11000001110101011111011110101
11110111 1110111 101111010001
11111111 1111111 111111111011
                          1